************************************************************
*..........................................................*
*****.***********.********...********************.**********
*.***.*............**......**..******************.*...******
*.***.***.***.****.**.********.....***......*****.*.*.....**
*.........*...**...**.************.***.....******...*****e**
***.*****...****.****.****..******.*****.****************..*
*...******.......*........................................s*
************************************************************