********************
*s................**
*****************.**
*e***..............*
*.*******.***.****.*
*.........*...**...*
***.************.***
*...******.......***
********************